_,_,_,_,_,_,_,M,_,_,_,_,_,_,_
_,P,W,W,W,W,W,_,W,W,W,W,W,P,_
_,W,_,_,_,3,W,_,W,_,_,_,_,W,_
_,W,_,_,_,_,W,T,W,_,_,_,_,W,_
_,W,_,_,_,W,_,W,_,W,4,_,_,W,_
_,W,_,_,W,_,_,W,_,_,W,_,_,W,_
_,W,_,W,_,_,W,_,_,_,_,W,_,W,_
_,W,_,_,_,_,_,W,_,_,_,_,_,W,_
_,W,_,_,_,_,_,_,W,_,_,_,_,_,S
_,W,_,_,_,_,_,W,_,_,_,@,_,W,_
_,W,W,W,_,_,_,_,_,_,_,W,_,W,_
_,W,_,W,_,_,_,P,_,_,_,W,2,W,_
_,W,1,W,_,_,W,C,W,_,_,W,_,W,W
_,W,_,W,_,_,_,W,_,_,_,W,_,W,_
_,F,_,@,_,W,_,E,_,W,_,W,_,_,_