_,_,_,_,_,_,_,_,M,_,_,_,_,_,_
_,_,_,_,_,_,_,_,_,_,_,_,_,_,_
_,_,_,_,W,T,_,_,_,_,_,_,_,_,_
_,_,_,_,W,W,_,W,W,_,_,_,_,_,_
_,_,_,_,_,_,_,_,_,_,_,_,_,_,_
_,_,_,_,_,_,_,_,_,_,_,_,_,_,_
_,_,_,_,_,_,_,_,_,_,_,_,_,_,_
_,_,_,1,_,_,_,_,_,_,_,_,_,@,_
_,_,_,_,2,_,_,_,_,_,_,_,_,_,_
_,_,_,_,_,3,_,_,_,_,_,_,_,_,_
_,_,_,_,_,_,_,_,_,_,_,_,_,_,_
_,_,_,_,_,_,_,F,_,_,_,_,C,_,_
_,_,_,_,_,_,P,_,S,_,_,_,_,_,_
_,_,@,_,W,_,W,_,W,_,_,_,_,_,_
_,_,_,W,_,_,_,E,_,_,_,_,_,_,_